0XFF:0XE4,0X00:0X00,0X02:0XE4,0X02:0XE4,0X02:0XE4,0X02:0XE4,0X02:0XE4,0X00:0X00,0X02:0XE4,0X02:0XE4,0X02:0XE4,0X02:0XE4,0X02:0XE4,0X00:0X00,0X02:0XE4,0X02:0XE4,0X02:0XE4,0X02:0XE4,0X02:0XE4,0X02:0XE5,0X02:0XE5,0X02:0XE4,0X02:0XE4,0X02:0XE4,0X02:0XE4,0X02:0XE4,0X02:0XE5,0X02:0XE4,0X02:0XE4,0X02:0XE4,0X02:0XE4,0X02:0XE4,0X02:0XE5,0X02:0XE4,0X02:0XE4,0X00:0X00,0X00:0X00,0X02:0XE5,0X02:0XE5,0X02:0XE5,0X00:0X00,0X02:0XE5,0X02:0XE5,0X02:0XE5,0X00:0X00,0X02:0XE5,0X02:0XE5,0X02:0XE5
0X02:0XE4,0X00:0X00,0X02:0XE4,0X02:0XE4,0X02:0XE4,0X02:0XE4,0X02:0XE4,0X00:0X00,0X02:0XE4,0X02:0XE4,0X02:0XE4,0X02:0XE4,0X02:0XE4,0X00:0X00,0X02:0XE4,0X02:0XE4,0X02:0XE4,0X02:0XE4,0X02:0XE4,0X02:0XE5,0X02:0XE5,0X02:0XE4,0X02:0XE4,0X02:0XE4,0X02:0XE4,0X02:0XE4,0X02:0XE5,0X02:0XE4,0X02:0XE4,0X02:0XE4,0X02:0XE4,0X02:0XE4,0X02:0XE5,0X02:0XE4,0X02:0XE4,0X02:0XE4,0X02:0XE5,0X02:0XE5,0X00:0X00,0X02:0XE5,0X02:0XE5,0X02:0XE5,0X00:0X00,0X02:0XE5,0X02:0XE5,0X02:0XE5,0X00:0X00,0X02:0XE5
0X02:0XE4,0X00:0X00,0X02:0XE4,0X02:0XE4,0X00:0X00,0X02:0XE4,0X02:0XE4,0X00:0X00,0X02:0XE4,0X02:0XE4,0X00:0X00,0X02:0XE4,0X02:0XE4,0X00:0X00,0X02:0XE4,0X02:0XE4,0X02:0XE5,0X02:0XE4,0X02:0XE4,0X02:0XE5,0X02:0XE4,0X02:0XE4,0X02:0XE4,0X02:0XE5,0X02:0XE4,0X02:0XE4,0X02:0XE4,0X02:0XE4,0X02:0XE4,0X02:0XE5,0X02:0XE4,0X02:0XE4,0X02:0XE4,0X02:0XE4,0X02:0XE4,0X00:0X00,0X00:0X00,0X00:0X00,0X00:0X00,0X00:0X00,0X00:0X00,0X00:0X00,0X00:0X00,0X00:0X00,0X00:0X00,0X00:0X00,0X00:0X00,0X02:0XE5
0X02:0XE4,0X00:0X00,0X02:0XE4,0X02:0XE4,0X00:0X00,0X02:0XE4,0X02:0XE4,0X00:0X00,0X02:0XE4,0X02:0XE4,0X00:0X00,0X02:0XE4,0X02:0XE4,0X00:0X00,0X02:0XE4,0X02:0XE4,0X02:0XE5,0X02:0XE4,0X02:0XE4,0X02:0XE5,0X02:0XE4,0X02:0XE4,0X02:0XE4,0X02:0XE5,0X02:0XE4,0X02:0XE4,0X02:0XE4,0X02:0XE4,0X02:0XE4,0X02:0XE5,0X02:0XE4,0X02:0XE4,0X02:0XE4,0X02:0XE4,0X02:0XE4,0X00:0X00,0X00:0X00,0X00:0X00,0X02:0XE6,0X02:0XE6,0X02:0XE6,0X00:0X00,0X02:0XE6,0X02:0XE6,0X02:0XE6,0X00:0X00,0X02:0XE6,0X02:0XE6
0X02:0XE4,0X00:0X00,0X02:0XE4,0X02:0XE4,0X00:0X00,0X02:0XE4,0X02:0XE4,0X00:0X00,0X02:0XE4,0X02:0XE4,0X00:0X00,0X02:0XE4,0X02:0XE4,0X00:0X00,0X02:0XE4,0X02:0XE4,0X02:0XE5,0X02:0XE4,0X02:0XE4,0X02:0XE5,0X02:0XE4,0X02:0XE5,0X02:0XE5,0X02:0XE5,0X02:0XE5,0X02:0XE5,0X02:0XE5,0X02:0XE5,0X02:0XE5,0X02:0XE5,0X02:0XE5,0X02:0XE5,0X02:0XE5,0X02:0XE4,0X02:0XE4,0X00:0X00,0X02:0XE6,0X02:0XE6,0X02:0XE6,0X00:0X00,0X02:0XE6,0X02:0XE6,0X02:0XE6,0X00:0X00,0X02:0XE6,0X02:0XE6,0X02:0XE6,0X00:0X00
0X02:0XE4,0X00:0X00,0X02:0XE4,0X02:0XE4,0X00:0X00,0X02:0XE4,0X02:0XE4,0X00:0X00,0X02:0XE4,0X02:0XE4,0X00:0X00,0X02:0XE4,0X02:0XE4,0X00:0X00,0X02:0XE4,0X02:0XE4,0X02:0XE5,0X02:0XE4,0X02:0XE4,0X02:0XE5,0X02:0XE4,0X02:0XE5,0X02:0XE5,0X02:0XE5,0X02:0XE5,0X02:0XE5,0X02:0XE5,0X02:0XE5,0X02:0XE5,0X02:0XE5,0X02:0XE5,0X02:0XE5,0X02:0XE5,0X02:0XE4,0X02:0XE4,0X00:0X00,0X02:0XE6,0X00:0X00,0X00:0X00,0X00:0X00,0X00:0X00,0X00:0X00,0X00:0X00,0X00:0X00,0X00:0X00,0X00:0X00,0X00:0X00,0X00:0X00
0X02:0XE4,0X02:0XE4,0X02:0XE4,0X02:0XE4,0X00:0X00,0X02:0XE4,0X02:0XE4,0X02:0XE4,0X02:0XE4,0X02:0XE4,0X00:0X00,0X02:0XE4,0X02:0XE4,0X02:0XE4,0X02:0XE4,0X02:0XE4,0X02:0XE5,0X02:0XE4,0X02:0XE4,0X02:0XE4,0X02:0XE4,0X02:0XE4,0X02:0XE4,0X02:0XE5,0X02:0XE4,0X02:0XE4,0X02:0XE4,0X02:0XE4,0X02:0XE4,0X02:0XE5,0X02:0XE4,0X02:0XE4,0X02:0XE4,0X02:0XE4,0X02:0XE4,0X00:0X00,0X02:0XE7,0X02:0XE7,0X00:0X00,0X02:0XE7,0X02:0XE7,0X02:0XE7,0X00:0X00,0X02:0XE7,0X02:0XE7,0X02:0XE7,0X00:0X00,0X00:0X00
0X02:0XE4,0X02:0XE4,0X02:0XE4,0X02:0XE4,0X00:0X00,0X02:0XE4,0X02:0XE4,0X02:0XE4,0X02:0XE4,0X02:0XE4,0X00:0X00,0X02:0XE4,0X02:0XE4,0X02:0XE4,0X02:0XE4,0X02:0XE4,0X02:0XE5,0X02:0XE4,0X02:0XE4,0X02:0XE4,0X02:0XE4,0X02:0XE4,0X02:0XE4,0X02:0XE5,0X02:0XE4,0X02:0XE4,0X02:0XE4,0X02:0XE4,0X02:0XE4,0X02:0XE5,0X02:0XE4,0X02:0XE4,0X02:0XE4,0X02:0XE4,0X02:0XE4,0X00:0X00,0X00:0X00,0X02:0XE7,0X02:0XE7,0X02:0XE7,0X00:0X00,0X02:0XE7,0X02:0XE7,0X02:0XE7,0X00:0X00,0X02:0XE7,0X02:0XE7,0X02:0XE7
0X02:0XE4,0X02:0XE4,0X00:0X00,0X00:0X00,0X00:0X00,0X00:0X00,0X00:0X00,0X00:0X00,0X00:0X00,0X00:0X00,0X00:0X00,0X00:0X00,0X00:0X00,0X00:0X00,0X00:0X00,0X00:0X00,0X02:0XE5,0X02:0XE5,0X02:0XE5,0X02:0XE5,0X02:0XE5,0X02:0XE4,0X02:0XE4,0X02:0XE4,0X02:0XE4,0X02:0XE4,0X02:0XE5,0X02:0XE4,0X02:0XE4,0X02:0XE4,0X02:0XE4,0X02:0XE4,0X02:0XE5,0X02:0XE4,0X02:0XE4,0X00:0X00,0X00:0X00,0X00:0X00,0X00:0X00,0X00:0X00,0X00:0X00,0X00:0X00,0X00:0X00,0X00:0X00,0X00:0X00,0X00:0X00,0X00:0X00,0X02:0XE7
0X02:0XE4,0X02:0XE4,0X02:0XE4,0X02:0XE4,0X02:0XE4,0X02:0XE4,0X02:0XE4,0X02:0XE4,0X02:0XE4,0X02:0XE4,0X02:0XE4,0X02:0XE4,0X02:0XE4,0X02:0XE4,0X02:0XE4,0X02:0XE4,0X02:0XE4,0X02:0XE4,0X02:0XE4,0X02:0XE4,0X02:0XE4,0X02:0XE4,0X02:0XE4,0X02:0XE4,0X02:0XE4,0X02:0XE4,0X02:0XE4,0X02:0XE4,0X02:0XE4,0X02:0XE4,0X02:0XE4,0X02:0XE4,0X02:0XE4,0X02:0XE4,0X02:0XE4,0X00:0X00,0X02:0XE8,0X02:0XE8,0X02:0XE8,0X02:0XE8,0X02:0XE8,0X02:0XE8,0X02:0XE8,0X02:0XE8,0X02:0XE8,0X02:0XE8,0X02:0XE8,0X02:0XE8
0X00:0X00,0X00:0X00,0X00:0X00,0X00:0X00,0X00:0X00,0X00:0X00,0X00:0X00,0X00:0X00,0X00:0X00,0X00:0X00,0X00:0X00,0X00:0X00,0X00:0X00,0X00:0X00,0X00:0X00,0X00:0X00,0X00:0X00,0X00:0X00,0X00:0X00,0X00:0X00,0X00:0X00,0X00:0X00,0X00:0X00,0X00:0X00,0X00:0X00,0X00:0X00,0X00:0X00,0X00:0X00,0X00:0X00,0X00:0X00,0X00:0X00,0X00:0X00,0X00:0X00,0X00:0X00,0X00:0X00,0X00:0X00,0X02:0XE8,0X00:0X00,0X00:0X00,0X00:0X00,0X00:0X00,0X00:0X00,0X00:0X00,0X00:0X00,0X00:0X00,0X00:0X00,0X00:0X00,0X00:0X00
0X00:0X00,0X00:0X00,0X00:0X00,0X00:0X00,0X00:0X00,0X00:0X00,0X00:0X00,0X00:0X00,0X00:0X00,0X00:0X00,0X00:0X00,0X00:0X00,0X00:0X00,0X00:0X00,0X00:0X00,0X00:0X00,0X00:0X00,0X00:0X00,0X00:0X00,0X00:0X00,0X00:0X00,0X00:0X00,0X00:0X00,0X00:0X00,0X00:0X00,0X00:0X00,0X00:0X00,0X00:0X00,0X00:0X00,0X00:0X00,0X00:0X00,0X00:0X00,0X00:0X00,0X00:0X00,0X00:0X00,0X00:0X00,0X02:0XE8,0X02:0XE8,0X02:0XE8,0X02:0XE8,0X02:0XE8,0X02:0XE8,0X02:0XE8,0X02:0XE8,0X02:0XE8,0X02:0XE8,0X02:0XE8,0X02:0XE8
0X00:0X00,0X00:0X00,0X00:0X00,0X00:0X00,0X00:0X00,0X00:0X00,0X00:0X00,0X00:0X00,0X00:0X00,0X00:0X00,0X00:0X00,0X00:0X00,0X00:0X00,0X00:0X00,0X00:0X00,0X00:0X00,0X00:0X00,0X00:0X00,0X00:0X00,0X00:0X00,0X00:0X00,0X00:0X00,0X00:0X00,0X00:0X00,0X00:0X00,0X00:0X00,0X00:0X00,0X00:0X00,0X00:0X00,0X00:0X00,0X00:0X00,0X00:0X00,0X00:0X00,0X00:0X00,0X00:0X00,0X00:0X00,0X00:0X00,0X00:0X00,0X00:0X00,0X00:0X00,0X00:0X00,0X00:0X00,0X00:0X00,0X00:0X00,0X00:0X00,0X00:0X00,0X00:0X00,0X02:0XE8
0X00:0X00,0X00:0X00,0X00:0X00,0X00:0X00,0X00:0X00,0X00:0X00,0X00:0X00,0X00:0X00,0X00:0X00,0X00:0X00,0X00:0X00,0X00:0X00,0X00:0X00,0X00:0X00,0X00:0X00,0X00:0X00,0X00:0X00,0X00:0X00,0X00:0X00,0X00:0X00,0X00:0X00,0X00:0X00,0X00:0X00,0X00:0X00,0X00:0X00,0X00:0X00,0X00:0X00,0X00:0X00,0X00:0X00,0X00:0X00,0X00:0X00,0X00:0X00,0X00:0X00,0X00:0X00,0X00:0X00,0X00:0X00,0X02:0XE9,0X02:0XE9,0X02:0XE9,0X02:0XE9,0X02:0XE9,0X02:0XE9,0X02:0XE8,0X02:0XE8,0X02:0XE8,0X02:0XE8,0X02:0XE8,0X02:0XE8
0X00:0X00,0X00:0X00,0X00:0X00,0X00:0X00,0X00:0X00,0X00:0X00,0X00:0X00,0X00:0X00,0X00:0X00,0X00:0X00,0X00:0X00,0X00:0X00,0X00:0X00,0X00:0X00,0X00:0X00,0X00:0X00,0X00:0X00,0X00:0X00,0X00:0X00,0X00:0X00,0X00:0X00,0X00:0X00,0X00:0X00,0X00:0X00,0X00:0X00,0X00:0X00,0X00:0X00,0X00:0X00,0X00:0X00,0X00:0X00,0X00:0X00,0X00:0X00,0X00:0X00,0X00:0X00,0X00:0X00,0X00:0X00,0X02:0XE9,0X00:0X00,0X00:0X00,0X00:0X00,0X00:0X00,0X00:0X00,0X00:0X00,0X00:0X00,0X00:0X00,0X00:0X00,0X00:0X00,0X00:0X00
0X00:0X00,0X00:0X00,0X00:0X00,0X00:0X00,0X00:0X00,0X00:0X00,0X00:0X00,0X00:0X00,0X00:0X00,0X00:0X00,0X00:0X00,0X00:0X00,0X00:0X00,0X00:0X00,0X00:0X00,0X00:0X00,0X00:0X00,0X00:0X00,0X00:0X00,0X00:0X00,0X00:0X00,0X00:0X00,0X00:0X00,0X00:0X00,0X00:0X00,0X00:0X00,0X00:0X00,0X00:0X00,0X00:0X00,0X00:0X00,0X00:0X00,0X00:0X00,0X00:0X00,0X00:0X00,0X00:0X00,0X00:0X00,0X02:0XE9,0X02:0XE9,0X02:0XE9,0X02:0XE9,0X02:0XE9,0X02:0XE9,0X02:0XE9,0X02:0XE9,0X02:0XE9,0X02:0XE9,0X02:0XE9,0X02:0XE9
0X00:0X00,0X00:0X00,0X00:0X00,0X00:0X00,0X00:0X00,0X00:0X00,0X00:0X00,0X00:0X00,0X00:0X00,0X00:0X00,0X00:0X00,0X00:0X00,0X00:0X00,0X00:0X00,0X00:0X00,0X00:0X00,0X00:0X00,0X00:0X00,0X00:0X00,0X00:0X00,0X00:0X00,0X00:0X00,0X00:0X00,0X00:0X00,0X00:0X00,0X00:0X00,0X00:0X00,0X00:0X00,0X00:0X00,0X00:0X00,0X00:0X00,0X00:0X00,0X00:0X00,0X00:0X00,0X00:0X00,0X00:0X00,0X00:0X00,0X00:0X00,0X00:0X00,0X00:0X00,0X00:0X00,0X00:0X00,0X00:0X00,0X00:0X00,0X00:0X00,0X00:0X00,0X00:0X00,0X02:0XE9
0X02:0XF1,0X02:0XF1,0X02:0XF1,0X02:0XF1,0X02:0XF1,0X02:0XF1,0X02:0XF1,0X02:0XF1,0X02:0XF1,0X02:0XF1,0X02:0XF1,0X02:0XF0,0X02:0XF0,0X02:0XF0,0X02:0XF0,0X02:0XF1,0X02:0XF2,0X02:0XF3,0X02:0XF4,0X02:0XF5,0X02:0XF6,0X02:0XF7,0X02:0XF8,0X02:0XF9,0X02:0XFA,0X02:0XFB,0X02:0XFC,0X02:0XFD,0X02:0XFE,0X02:0XFF,0X00:0X00,0X00:0X00,0X00:0X00,0X00:0X00,0X00:0X00,0X00:0X00,0X02:0XEA,0X02:0XEA,0X02:0XEA,0X02:0XEA,0X02:0XEA,0X02:0XEA,0X02:0XE9,0X02:0XE9,0X02:0XE9,0X02:0XE9,0X02:0XE9,0X02:0XE9
0X02:0XF1,0X00:0X00,0X02:0XF0,0X02:0XF0,0X02:0XF0,0X02:0XF0,0X02:0XF0,0X02:0XF0,0X02:0XF0,0X02:0XF0,0X02:0XF0,0X02:0XF0,0X02:0XF0,0X02:0XF1,0X00:0X00,0X00:0X00,0X00:0X00,0X00:0X00,0X00:0X00,0X00:0X00,0X00:0X00,0X00:0X00,0X00:0X00,0X00:0X00,0X00:0X00,0X00:0X00,0X00:0X00,0X00:0X00,0X00:0X00,0X02:0XFF,0X00:0X00,0X00:0X00,0X00:0X00,0X00:0X00,0X00:0X00,0X00:0X00,0X02:0XEA,0X00:0X00,0X00:0X00,0X00:0X00,0X00:0X00,0X00:0X00,0X00:0X00,0X00:0X00,0X00:0X00,0X00:0X00,0X00:0X00,0X00:0X00
0X02:0XF1,0X02:0XF0,0X02:0XF0,0X02:0XF0,0X02:0XF0,0X02:0XF0,0X02:0XF0,0X02:0XF0,0X02:0XF0,0X02:0XF0,0X02:0XF0,0X02:0XF0,0X00:0X00,0X02:0XF1,0X00:0X00,0X00:0X00,0X00:0X00,0X00:0X00,0X00:0X00,0X02:0XFF,0X02:0XFF,0X02:0XFF,0X02:0XFF,0X02:0XFF,0X02:0XFF,0X02:0XFF,0X02:0XFF,0X02:0XFF,0X00:0X00,0X02:0XFF,0X00:0X00,0X00:0X00,0X00:0X00,0X00:0X00,0X00:0X00,0X00:0X00,0X02:0XEA,0X02:0XEA,0X02:0XEA,0X02:0XEA,0X02:0XEA,0X02:0XEA,0X02:0XEA,0X02:0XEA,0X02:0XEA,0X02:0XEA,0X02:0XEA,0X02:0XEA
0X02:0XF1,0X02:0XF0,0X02:0XF0,0X02:0XF1,0X02:0XF1,0X02:0XF1,0X02:0XF1,0X02:0XF1,0X02:0XF1,0X02:0XF1,0X02:0XF1,0X02:0XF1,0X02:0XF1,0X02:0XF1,0X00:0X00,0X00:0X00,0X00:0X00,0X00:0X00,0X00:0X00,0X02:0XFF,0X00:0X00,0X00:0X00,0X00:0X00,0X00:0X00,0X00:0X00,0X00:0X00,0X00:0X00,0X02:0XFF,0X00:0X00,0X02:0XFF,0X00:0X00,0X00:0X00,0X00:0X00,0X00:0X00,0X00:0X00,0X00:0X00,0X00:0X00,0X00:0X00,0X00:0X00,0X00:0X00,0X00:0X00,0X00:0X00,0X00:0X00,0X00:0X00,0X00:0X00,0X00:0X00,0X00:0X00,0X02:0XEA
0X02:0XF1,0X02:0XF0,0X02:0XF0,0X02:0XF0,0X02:0XF0,0X02:0XF0,0X02:0XF0,0X02:0XF0,0X02:0XF0,0X02:0XF0,0X02:0XF0,0X02:0XF0,0X00:0X00,0X02:0XF1,0X00:0X00,0X00:0X00,0X00:0X00,0X00:0X00,0X00:0X00,0X02:0XFF,0X00:0X00,0X02:0XFF,0X02:0XFF,0X02:0XFF,0X02:0XFF,0X02:0XFF,0X00:0X00,0X02:0XFF,0X00:0X00,0X02:0XFF,0X00:0X00,0X00:0X00,0X00:0X00,0X00:0X00,0X00:0X00,0X00:0X00,0X02:0XEA,0X02:0XEA,0X02:0XEA,0X02:0XEA,0X02:0XEA,0X02:0XEA,0X02:0XEA,0X02:0XEA,0X02:0XEA,0X02:0XEA,0X02:0XEA,0X02:0XEA
0X02:0XF1,0X00:0X00,0X02:0XF0,0X02:0XF0,0X02:0XF0,0X02:0XF0,0X02:0XF0,0X02:0XF0,0X02:0XF0,0X02:0XF0,0X02:0XF0,0X02:0XF0,0X02:0XF0,0X02:0XF1,0X00:0X00,0X00:0X00,0X00:0X00,0X00:0X00,0X00:0X00,0X02:0XFF,0X00:0X00,0X02:0XFF,0X00:0X00,0X00:0X00,0X00:0X00,0X02:0XFF,0X00:0X00,0X02:0XFF,0X00:0X00,0X02:0XFF,0X00:0X00,0X00:0X00,0X00:0X00,0X00:0X00,0X00:0X00,0X00:0X00,0X02:0XEA,0X00:0X00,0X00:0X00,0X00:0X00,0X00:0X00,0X00:0X00,0X00:0X00,0X00:0X00,0X00:0X00,0X00:0X00,0X00:0X00,0X00:0X00
0X02:0XF1,0X02:0XF1,0X02:0XF1,0X02:0XF1,0X02:0XF1,0X02:0XF1,0X02:0XF1,0X02:0XF1,0X02:0XF1,0X02:0XF1,0X02:0XF1,0X02:0XF0,0X02:0XF0,0X02:0XF1,0X00:0X00,0X00:0X00,0X00:0X00,0X00:0X00,0X00:0X00,0X02:0XFF,0X00:0X00,0X02:0XFF,0X00:0X00,0X01:0XFF,0X00:0X00,0X02:0XFF,0X00:0X00,0X02:0XFF,0X00:0X00,0X02:0XFF,0X00:0X00,0X00:0X00,0X00:0X00,0X00:0X00,0X00:0X00,0X00:0X00,0X02:0XEA,0X02:0XEA,0X02:0XEA,0X02:0XEA,0X02:0XEA,0X02:0XEA,0X02:0XEB,0X02:0XEB,0X02:0XEB,0X02:0XEB,0X02:0XEB,0X02:0XEB
0X02:0XF1,0X00:0X00,0X02:0XF0,0X02:0XF0,0X02:0XF0,0X02:0XF0,0X02:0XF0,0X02:0XF0,0X02:0XF0,0X02:0XF0,0X02:0XF0,0X02:0XF0,0X02:0XF0,0X02:0XF1,0X00:0X00,0X00:0X00,0X00:0X00,0X00:0X00,0X00:0X00,0X02:0XFF,0X00:0X00,0X02:0XFF,0X00:0X00,0X02:0XFF,0X02:0XFF,0X02:0XFF,0X00:0X00,0X02:0XFF,0X00:0X00,0X02:0XFF,0X00:0X00,0X00:0X00,0X00:0X00,0X00:0X00,0X00:0X00,0X00:0X00,0X00:0X00,0X00:0X00,0X00:0X00,0X00:0X00,0X00:0X00,0X00:0X00,0X00:0X00,0X00:0X00,0X00:0X00,0X00:0X00,0X00:0X00,0X02:0XEB
0X02:0XF1,0X02:0XF0,0X02:0XF0,0X02:0XF0,0X02:0XF0,0X02:0XF0,0X02:0XF0,0X02:0XF0,0X02:0XF0,0X02:0XF0,0X02:0XF0,0X02:0XF0,0X00:0X00,0X02:0XF1,0X00:0X00,0X00:0X00,0X00:0X00,0X00:0X00,0X00:0X00,0X02:0XFF,0X00:0X00,0X02:0XFF,0X00:0X00,0X00:0X00,0X00:0X00,0X00:0X00,0X00:0X00,0X02:0XFF,0X00:0X00,0X02:0XFF,0X00:0X00,0X00:0X00,0X00:0X00,0X00:0X00,0X00:0X00,0X00:0X00,0X02:0XEB,0X02:0XEB,0X02:0XEB,0X02:0XEB,0X02:0XEB,0X02:0XEB,0X02:0XEB,0X02:0XEB,0X02:0XEB,0X02:0XEB,0X02:0XEB,0X02:0XEB
0X02:0XF1,0X02:0XF0,0X02:0XF0,0X02:0XF1,0X02:0XF1,0X02:0XF1,0X02:0XF1,0X02:0XF1,0X02:0XF1,0X02:0XF1,0X02:0XF1,0X02:0XF1,0X02:0XF1,0X02:0XF1,0X00:0X00,0X00:0X00,0X00:0X00,0X00:0X00,0X00:0X00,0X02:0XFF,0X00:0X00,0X02:0XFF,0X02:0XFF,0X02:0XFF,0X02:0XFF,0X02:0XFF,0X02:0XFF,0X02:0XFF,0X00:0X00,0X02:0XFF,0X00:0X00,0X00:0X00,0X00:0X00,0X00:0X00,0X00:0X00,0X00:0X00,0X02:0XEB,0X00:0X00,0X00:0X00,0X00:0X00,0X00:0X00,0X00:0X00,0X00:0X00,0X00:0X00,0X00:0X00,0X00:0X00,0X00:0X00,0X00:0X00
0X02:0XF1,0X02:0XF0,0X02:0XF0,0X02:0XF0,0X02:0XF0,0X02:0XF0,0X02:0XF0,0X02:0XF0,0X02:0XF0,0X02:0XF0,0X02:0XF0,0X02:0XF0,0X00:0X00,0X02:0XF1,0X00:0X00,0X00:0X00,0X00:0X00,0X00:0X00,0X00:0X00,0X02:0XFF,0X00:0X00,0X00:0X00,0X00:0X00,0X00:0X00,0X00:0X00,0X00:0X00,0X00:0X00,0X00:0X00,0X00:0X00,0X02:0XFF,0X00:0X00,0X00:0X00,0X00:0X00,0X00:0X00,0X00:0X00,0X00:0X00,0X02:0XEB,0X02:0XEB,0X02:0XEB,0X02:0XEB,0X02:0XEB,0X02:0XEB,0X02:0XEB,0X02:0XEB,0X02:0XEB,0X02:0XEB,0X02:0XEB,0X02:0XEB
0X02:0XF1,0X00:0X00,0X02:0XF0,0X02:0XF0,0X02:0XF0,0X02:0XF0,0X02:0XF0,0X02:0XF0,0X02:0XF0,0X02:0XF0,0X02:0XF0,0X02:0XF0,0X02:0XF0,0X02:0XF1,0X00:0X00,0X00:0X00,0X00:0X00,0X00:0X00,0X00:0X00,0X02:0XFF,0X02:0XFF,0X02:0XFF,0X02:0XFF,0X02:0XFF,0X02:0XFF,0X02:0XFF,0X02:0XFF,0X02:0XFF,0X02:0XFF,0X02:0XFF,0X00:0X00,0X00:0X00,0X00:0X00,0X00:0X00,0X00:0X00,0X00:0X00,0X00:0X00,0X00:0X00,0X00:0X00,0X00:0X00,0X00:0X00,0X00:0X00,0X00:0X00,0X00:0X00,0X00:0X00,0X00:0X00,0X00:0X00,0X02:0XEB
0X02:0XF1,0X02:0XF1,0X02:0XF1,0X02:0XF1,0X02:0XF1,0X02:0XF1,0X02:0XF1,0X02:0XF1,0X02:0XF1,0X02:0XF1,0X02:0XF1,0X02:0XF0,0X02:0XF0,0X02:0XF1,0X00:0X00,0X00:0X00,0X00:0X00,0X00:0X00,0X00:0X00,0X00:0X00,0X00:0X00,0X00:0X00,0X00:0X00,0X00:0X00,0X00:0X00,0X00:0X00,0X00:0X00,0X00:0X00,0X00:0X00,0X00:0X00,0X00:0X00,0X00:0X00,0X00:0X00,0X00:0X00,0X00:0X00,0X00:0X00,0X02:0XEB,0X02:0XEB,0X02:0XEB,0X02:0XEB,0X02:0XEB,0X02:0XEB,0X02:0XEB,0X02:0XEB,0X02:0XEB,0X02:0XEB,0X02:0XEB,0X02:0XEB
0X02:0XF1,0X00:0X00,0X02:0XF0,0X02:0XF0,0X02:0XF0,0X02:0XF0,0X02:0XF0,0X02:0XF0,0X02:0XF0,0X02:0XF0,0X02:0XF0,0X02:0XF0,0X02:0XF0,0X02:0XF1,0X00:0X00,0X00:0X00,0X00:0X00,0X00:0X00,0X00:0X00,0X00:0X00,0X00:0X00,0X00:0X00,0X00:0X00,0X00:0X00,0X00:0X00,0X00:0X00,0X00:0X00,0X00:0X00,0X00:0X00,0X00:0X00,0X00:0X00,0X00:0X00,0X00:0X00,0X00:0X00,0X00:0X00,0X00:0X00,0X02:0XEB,0X00:0X00,0X00:0X00,0X00:0X00,0X00:0X00,0X00:0X00,0X00:0X00,0X00:0X00,0X00:0X00,0X00:0X00,0X00:0X00,0X00:0X00
0X02:0XF1,0X02:0XF0,0X02:0XF0,0X02:0XF0,0X02:0XF0,0X02:0XF0,0X02:0XF0,0X02:0XF0,0X02:0XF0,0X02:0XF0,0X02:0XF0,0X02:0XF0,0X00:0X00,0X02:0XF1,0X00:0X00,0X00:0X00,0X00:0X00,0X00:0X00,0X00:0X00,0X00:0X00,0X00:0X00,0X00:0X00,0X00:0X00,0X00:0X00,0X00:0X00,0X00:0X00,0X00:0X00,0X00:0X00,0X00:0X00,0X00:0X00,0X00:0X00,0X00:0X00,0X00:0X00,0X00:0X00,0X00:0X00,0X00:0X00,0X02:0XEB,0X02:0XEB,0X02:0XEB,0X02:0XEB,0X02:0XEB,0X02:0XEB,0X02:0XEB,0X02:0XEB,0X02:0XEB,0X02:0XEB,0X02:0XEB,0X02:0XEB
0X02:0XF1,0X02:0XF0,0X02:0XF0,0X02:0XF1,0X02:0XF1,0X02:0XF1,0X02:0XF1,0X02:0XF1,0X02:0XF1,0X02:0XF1,0X02:0XF1,0X02:0XF1,0X02:0XF1,0X02:0XF1,0X00:0X00,0X00:0X00,0X00:0X00,0X00:0X00,0X00:0X00,0X00:0X00,0X00:0X00,0X00:0X00,0X00:0X00,0X00:0X00,0X00:0X00,0X00:0X00,0X00:0X00,0X00:0X00,0X00:0X00,0X00:0X00,0X00:0X00,0X00:0X00,0X00:0X00,0X00:0X00,0X00:0X00,0X00:0X00,0X00:0X00,0X00:0X00,0X00:0X00,0X00:0X00,0X00:0X00,0X00:0X00,0X00:0X00,0X00:0X00,0X00:0X00,0X00:0X00,0X00:0X00,0X02:0XEB
0X02:0XF1,0X02:0XF0,0X02:0XF0,0X02:0XF1,0X00:0X00,0X02:0XF0,0X02:0XF0,0X02:0XF0,0X00:0X00,0X02:0XF1,0X02:0XF1,0X00:0X00,0X02:0XF1,0X02:0XF1,0X00:0X00,0X00:0X00,0X00:0X00,0X00:0X00,0X00:0X00,0X00:0X00,0X00:0X00,0X00:0X00,0X00:0X00,0X00:0X00,0X00:0X00,0X00:0X00,0X00:0X00,0X00:0X00,0X00:0X00,0X00:0X00,0X00:0X00,0X00:0X00,0X00:0X00,0X00:0X00,0X00:0X00,0X00:0X00,0X02:0XEB,0X02:0XEB,0X02:0XEB,0X02:0XEB,0X02:0XEB,0X02:0XEB,0X02:0XEB,0X02:0XEB,0X02:0XEB,0X02:0XEB,0X02:0XEB,0X02:0XEB
0X02:0XF1,0X02:0XF0,0X02:0XF0,0X02:0XF1,0X02:0XF0,0X02:0XF0,0X02:0XF0,0X02:0XF0,0X02:0XF0,0X02:0XF1,0X02:0XF0,0X02:0XF0,0X02:0XF0,0X02:0XF1,0X00:0X00,0X00:0X00,0X00:0X00,0X00:0X00,0X00:0X00,0X00:0X00,0X00:0X00,0X00:0X00,0X00:0X00,0X00:0X00,0X00:0X00,0X00:0X00,0X00:0X00,0X00:0X00,0X00:0X00,0X00:0X00,0X00:0X00,0X00:0X00,0X00:0X00,0X00:0X00,0X00:0X00,0X00:0X00,0X02:0XEB,0X00:0X00,0X00:0X00,0X00:0X00,0X00:0X00,0X00:0X00,0X00:0X00,0X00:0X00,0X00:0X00,0X00:0X00,0X00:0X00,0X00:0X00
0X02:0XF1,0X02:0XF0,0X02:0XF0,0X02:0XF1,0X02:0XF0,0X02:0XF0,0X02:0XF0,0X02:0XF0,0X02:0XF0,0X02:0XF1,0X02:0XF0,0X02:0XF0,0X02:0XF0,0X02:0XF0,0X02:0XEF,0X02:0XEF,0X00:0X00,0X02:0XEF,0X02:0XEF,0X02:0XEE,0X02:0XEE,0X02:0XEE,0X00:0X00,0X02:0XEE,0X02:0XEE,0X02:0XEE,0X02:0XEE,0X02:0XEE,0X00:0X00,0X02:0XEE,0X02:0XEE,0X02:0XEE,0X02:0XEE,0X02:0XEE,0X00:0X00,0X00:0X00,0X02:0XEC,0X02:0XEC,0X02:0XEC,0X02:0XEC,0X02:0XEC,0X02:0XEC,0X02:0XEC,0X02:0XEC,0X02:0XEC,0X02:0XEC,0X02:0XEC,0X02:0XEC
0X02:0XF1,0X02:0XF0,0X02:0XF0,0X02:0XF1,0X02:0XF0,0X02:0XF0,0X02:0XF1,0X02:0XF0,0X02:0XF0,0X02:0XF1,0X02:0XF0,0X02:0XF0,0X02:0XF0,0X02:0XF0,0X02:0XEF,0X02:0XEF,0X00:0X00,0X02:0XEF,0X02:0XEF,0X02:0XEE,0X02:0XEE,0X02:0XEE,0X00:0X00,0X02:0XEE,0X02:0XEE,0X02:0XEE,0X02:0XEE,0X02:0XEE,0X00:0X00,0X02:0XEE,0X02:0XEE,0X02:0XEE,0X02:0XEE,0X02:0XEE,0X00:0X00,0X00:0X00,0X00:0X00,0X00:0X00,0X00:0X00,0X00:0X00,0X00:0X00,0X00:0X00,0X00:0X00,0X00:0X00,0X00:0X00,0X00:0X00,0X00:0X00,0X02:0XEC
0X02:0XF1,0X02:0XF0,0X02:0XF0,0X02:0XF1,0X02:0XF0,0X02:0XF0,0X02:0XF1,0X02:0XF0,0X02:0XF0,0X02:0XF1,0X02:0XF0,0X02:0XF0,0X02:0XF0,0X02:0XF0,0X02:0XEF,0X02:0XEF,0X00:0X00,0X02:0XEF,0X02:0XEF,0X02:0XEE,0X02:0XEE,0X02:0XEE,0X00:0X00,0X02:0XEE,0X02:0XEE,0X02:0XEE,0X02:0XEE,0X02:0XEE,0X00:0X00,0X02:0XEE,0X02:0XEE,0X02:0XEE,0X02:0XEE,0X02:0XEE,0X00:0X00,0X02:0XEE,0X02:0XED,0X02:0XED,0X02:0XED,0X02:0XED,0X00:0X00,0X02:0XED,0X02:0XEC,0X02:0XEC,0X02:0XEC,0X02:0XEC,0X00:0X00,0X02:0XEC
0X02:0XF1,0X02:0XF0,0X02:0XF0,0X02:0XF1,0X02:0XF0,0X02:0XF0,0X02:0XF1,0X02:0XF0,0X02:0XF0,0X02:0XF1,0X02:0XF0,0X02:0XF0,0X02:0XF1,0X02:0XF1,0X02:0XEF,0X02:0XEF,0X00:0X00,0X02:0XEF,0X02:0XEF,0X00:0X00,0X02:0XEE,0X02:0XEE,0X00:0X00,0X02:0XEE,0X02:0XEE,0X00:0X00,0X02:0XEE,0X02:0XEE,0X00:0X00,0X02:0XEE,0X02:0XEE,0X00:0X00,0X02:0XEE,0X02:0XEE,0X00:0X00,0X02:0XEE,0X02:0XED,0X02:0XED,0X02:0XED,0X02:0XED,0X00:0X00,0X02:0XED,0X02:0XEC,0X02:0XEC,0X02:0XEC,0X02:0XEC,0X00:0X00,0X02:0XEC
0X02:0XF1,0X02:0XF0,0X02:0XF0,0X02:0XF1,0X02:0XF0,0X02:0XF0,0X02:0XF1,0X02:0XF0,0X02:0XF0,0X02:0XF1,0X02:0XF0,0X02:0XF0,0X02:0XF0,0X02:0XF1,0X02:0XEF,0X02:0XEF,0X00:0X00,0X02:0XEF,0X02:0XEF,0X00:0X00,0X02:0XEE,0X02:0XEE,0X00:0X00,0X02:0XEE,0X02:0XEE,0X00:0X00,0X02:0XEE,0X02:0XEE,0X00:0X00,0X02:0XEE,0X02:0XEE,0X00:0X00,0X02:0XEE,0X02:0XEE,0X00:0X00,0X02:0XEE,0X02:0XED,0X02:0XED,0X02:0XED,0X02:0XED,0X00:0X00,0X02:0XED,0X02:0XEC,0X02:0XEC,0X02:0XEC,0X02:0XEC,0X00:0X00,0X02:0XEC
0X02:0XF1,0X02:0XF0,0X02:0XF0,0X02:0XF1,0X02:0XF0,0X02:0XF0,0X02:0XF1,0X02:0XF0,0X02:0XF0,0X02:0XF1,0X02:0XF0,0X02:0XF0,0X02:0XF0,0X02:0XF1,0X02:0XEF,0X02:0XEF,0X00:0X00,0X02:0XEF,0X02:0XEF,0X00:0X00,0X02:0XEE,0X02:0XEE,0X00:0X00,0X02:0XEE,0X02:0XEE,0X00:0X00,0X02:0XEE,0X02:0XEE,0X00:0X00,0X02:0XEE,0X02:0XEE,0X00:0X00,0X02:0XEE,0X02:0XEE,0X00:0X00,0X02:0XEE,0X02:0XED,0X00:0X00,0X02:0XED,0X02:0XED,0X00:0X00,0X02:0XED,0X02:0XEC,0X00:0X00,0X02:0XEC,0X02:0XEC,0X00:0X00,0X02:0XEC
0X02:0XF1,0X02:0XF0,0X02:0XF0,0X02:0XF1,0X02:0XF0,0X02:0XF0,0X02:0XF1,0X02:0XF0,0X02:0XF0,0X02:0XF1,0X02:0XF1,0X02:0XF0,0X02:0XF0,0X02:0XF1,0X02:0XEF,0X02:0XEF,0X00:0X00,0X02:0XEF,0X02:0XEF,0X00:0X00,0X02:0XEE,0X02:0XEE,0X00:0X00,0X02:0XEE,0X02:0XEE,0X00:0X00,0X02:0XEE,0X02:0XEE,0X00:0X00,0X02:0XEE,0X02:0XEE,0X00:0X00,0X02:0XEE,0X02:0XEE,0X00:0X00,0X02:0XEE,0X02:0XED,0X00:0X00,0X02:0XED,0X02:0XED,0X00:0X00,0X02:0XED,0X02:0XEC,0X00:0X00,0X02:0XEC,0X02:0XEC,0X00:0X00,0X02:0XEC
0X02:0XF1,0X02:0XF0,0X02:0XF0,0X02:0XF1,0X02:0XF0,0X02:0XF0,0X02:0XF1,0X02:0XF0,0X02:0XF0,0X02:0XF1,0X02:0XF1,0X02:0XF0,0X02:0XF0,0X02:0XF1,0X02:0XEF,0X02:0XEF,0X00:0X00,0X02:0XEF,0X02:0XEF,0X00:0X00,0X02:0XEE,0X02:0XEE,0X00:0X00,0X02:0XEE,0X02:0XEE,0X00:0X00,0X02:0XEE,0X02:0XEE,0X00:0X00,0X02:0XEE,0X02:0XEE,0X00:0X00,0X02:0XEE,0X02:0XEE,0X00:0X00,0X02:0XEE,0X02:0XED,0X00:0X00,0X02:0XED,0X02:0XED,0X00:0X00,0X02:0XED,0X02:0XEC,0X00:0X00,0X02:0XEC,0X02:0XEC,0X00:0X00,0X02:0XEC
0X02:0XF1,0X02:0XF0,0X02:0XF0,0X02:0XF1,0X02:0XF0,0X02:0XF0,0X02:0XF1,0X02:0XF0,0X02:0XF0,0X02:0XF1,0X02:0XF1,0X02:0XF0,0X02:0XF0,0X02:0XF1,0X02:0XEF,0X02:0XEF,0X00:0X00,0X02:0XEF,0X02:0XEF,0X00:0X00,0X02:0XEE,0X02:0XEE,0X00:0X00,0X02:0XEE,0X02:0XEE,0X00:0X00,0X02:0XEE,0X02:0XEE,0X00:0X00,0X02:0XEE,0X02:0XEE,0X00:0X00,0X02:0XEE,0X02:0XEE,0X00:0X00,0X02:0XEE,0X02:0XED,0X00:0X00,0X02:0XED,0X02:0XED,0X00:0X00,0X02:0XED,0X02:0XEC,0X00:0X00,0X02:0XEC,0X02:0XEC,0X00:0X00,0X02:0XEC
0X02:0XF1,0X02:0XF0,0X02:0XF0,0X02:0XF0,0X02:0XF0,0X02:0XF0,0X02:0XF1,0X02:0XF0,0X02:0XF0,0X02:0XF0,0X02:0XF0,0X02:0XF0,0X02:0XF0,0X02:0XF1,0X02:0XEF,0X02:0XEF,0X00:0X00,0X02:0XEF,0X02:0XEF,0X00:0X00,0X02:0XEE,0X02:0XEE,0X00:0X00,0X02:0XEE,0X02:0XEE,0X00:0X00,0X02:0XEE,0X02:0XEE,0X00:0X00,0X02:0XEE,0X02:0XEE,0X00:0X00,0X02:0XEE,0X02:0XEE,0X00:0X00,0X02:0XEE,0X02:0XED,0X00:0X00,0X02:0XED,0X02:0XED,0X00:0X00,0X02:0XED,0X02:0XEC,0X00:0X00,0X02:0XEC,0X02:0XEC,0X00:0X00,0X02:0XEC
0X02:0XF1,0X02:0XF0,0X02:0XF0,0X02:0XF0,0X02:0XF0,0X02:0XF0,0X02:0XF1,0X02:0XF0,0X02:0XF0,0X02:0XF0,0X02:0XF0,0X02:0XF0,0X02:0XF0,0X02:0XF1,0X02:0XEF,0X02:0XEF,0X02:0XEF,0X02:0XEF,0X02:0XEF,0X00:0X00,0X02:0XEE,0X02:0XEE,0X02:0XEE,0X02:0XEE,0X02:0XEE,0X00:0X00,0X02:0XEE,0X02:0XEE,0X02:0XEE,0X02:0XEE,0X02:0XEE,0X00:0X00,0X02:0XEE,0X02:0XEE,0X00:0X00,0X02:0XEE,0X02:0XED,0X00:0X00,0X02:0XED,0X02:0XED,0X02:0XED,0X02:0XED,0X02:0XEC,0X00:0X00,0X02:0XEC,0X02:0XEC,0X02:0XEC,0X02:0XEC
0X02:0XF1,0X00:0X00,0X02:0XF0,0X02:0XF0,0X02:0XF0,0X00:0X00,0X02:0XF1,0X00:0X00,0X02:0XF0,0X02:0XF0,0X02:0XF0,0X02:0XF0,0X00:0X00,0X02:0XF1,0X02:0XEF,0X02:0XEF,0X02:0XEF,0X02:0XEF,0X02:0XEF,0X00:0X00,0X02:0XEE,0X02:0XEE,0X02:0XEE,0X02:0XEE,0X02:0XEE,0X00:0X00,0X02:0XEE,0X02:0XEE,0X02:0XEE,0X02:0XEE,0X02:0XEE,0X00:0X00,0X02:0XEE,0X02:0XEE,0X02:0XEE,0X02:0XEE,0X02:0XED,0X00:0X00,0X02:0XED,0X02:0XED,0X02:0XED,0X02:0XED,0X02:0XEC,0X00:0X00,0X02:0XEC,0X02:0XEC,0X02:0XEC,0X02:0XEC
0X02:0XF1,0X02:0XF1,0X02:0XF1,0X02:0XF1,0X02:0XF1,0X02:0XF1,0X02:0XF1,0X02:0XF1,0X02:0XF1,0X02:0XF1,0X02:0XF1,0X02:0XF1,0X02:0XF1,0X02:0XF1,0X02:0XEF,0X02:0XEF,0X02:0XEF,0X02:0XEF,0X02:0XEF,0X00:0X00,0X02:0XEE,0X02:0XEE,0X02:0XEE,0X02:0XEE,0X02:0XEE,0X00:0X00,0X02:0XEE,0X02:0XEE,0X02:0XEE,0X02:0XEE,0X02:0XEE,0X00:0X00,0X02:0XEE,0X02:0XEE,0X02:0XEE,0X02:0XEE,0X02:0XED,0X00:0X00,0X02:0XED,0X02:0XED,0X02:0XED,0X02:0XED,0X02:0XEC,0X00:0X00,0X02:0XEC,0X02:0XEC,0X02:0XEC,0X02:0XEC
