0x01:0xFE,0x00:0x00,0x00:0x00,0x02:0xE0,0x02:0xE0,0x02:0xE1,0x02:0xE2,0x02:0xE3,0x02:0xE4,0x02:0xE5,0x02:0xE6,0x02:0xE6
0x02:0xFE,0x00:0x00,0x00:0x00,0x02:0xE0,0x00:0x00,0x00:0x00,0x00:0x00,0x00:0x00,0x00:0x00,0x00:0x00,0x00:0x00,0x02:0xE6
0x02:0xFE,0x00:0x00,0x00:0x00,0x02:0xDF,0x00:0x00,0x00:0x00,0x00:0x00,0x00:0x00,0x00:0x00,0x00:0x00,0x00:0x00,0x02:0xE6
0x02:0xFE,0x00:0x00,0x00:0x00,0x02:0xDF,0x00:0x00,0x00:0x00,0x02:0xD0,0x02:0xD1,0x02:0xD2,0x00:0x00,0x00:0x00,0x02:0xE8
0x02:0xFE,0x00:0x00,0x00:0x00,0x02:0xDD,0x00:0x00,0x00:0x00,0x02:0xD0,0x00:0x00,0x02:0xD3,0x00:0x00,0x00:0x00,0x02:0xE8
0x00:0x00,0x00:0x00,0x00:0x00,0x02:0xDD,0x00:0x00,0x00:0x00,0xFF:0xD0,0x00:0x00,0x02:0xD4,0x00:0x00,0x00:0x00,0x02:0xE8
0x00:0x00,0x00:0x00,0x00:0x00,0x02:0xDD,0x00:0x00,0x00:0x00,0x00:0x00,0x00:0x00,0x02:0xD5,0x00:0x00,0x00:0x00,0x02:0xEA
0x00:0x00,0x00:0x00,0x00:0x00,0x02:0xDB,0x00:0x00,0x00:0x00,0x00:0x00,0x00:0x00,0x02:0xD6,0x00:0x00,0x00:0x00,0x02:0xEA
0x02:0xF4,0x00:0x00,0x00:0x00,0x02:0xDB,0x02:0xDB,0x02:0xDA,0x02:0xD9,0x02:0xD8,0x02:0xD7,0x00:0x00,0x00:0x00,0x02:0xEA
0x02:0xF4,0x00:0x00,0x00:0x00,0x00:0x00,0x00:0x00,0x00:0x00,0x00:0x00,0x00:0x00,0x00:0x00,0x00:0x00,0x00:0x00,0x02:0xEB
0x02:0xF4,0x00:0x00,0x00:0x00,0x00:0x00,0x00:0x00,0x00:0x00,0x00:0x00,0x00:0x00,0x00:0x00,0x00:0x00,0x00:0x00,0x02:0xEB
0x02:0xF6,0x02:0xF5,0x02:0xF4,0x02:0xF3,0x02:0xF2,0x02:0xF1,0x02:0xF0,0x02:0xEF,0x02:0xEE,0x02:0xED,0x02:0xEC,0x02:0xEB
