0x02:0x01,0x02:0x01,0x02:0x01,0x02:0x01,0x02:0x01,0x02:0x01,0x02:0x01,0x02:0x01,0x02:0x01,0x02:0x01,0x02:0x01,0x02:0x01
0x02:0x01,0x01:0x00,0x02:0x00,0x02:0x00,0x02:0x00,0x02:0x00,0x02:0x00,0x02:0x00,0x02:0x00,0x02:0x00,0x02:0x00,0x02:0x01
0x02:0x01,0x02:0x00,0x02:0x00,0x02:0x00,0x02:0x00,0x02:0x00,0x02:0x00,0x02:0x00,0x02:0x00,0x02:0x00,0x02:0x00,0x02:0x01
0x02:0x01,0x02:0x00,0x02:0x00,0x02:0x00,0x02:0x00,0x02:0x00,0x02:0x00,0x02:0x00,0x02:0x00,0x02:0x00,0x02:0x00,0x02:0x01
0x02:0x01,0x02:0x00,0x02:0x00,0x02:0x00,0x02:0x00,0x02:0x00,0x02:0x00,0x02:0x00,0x02:0x00,0x02:0x00,0x02:0x00,0x02:0x01
0x02:0x01,0x02:0x00,0x02:0x00,0x02:0x00,0x02:0x00,0x02:0x00,0x02:0x00,0x02:0x00,0x02:0x00,0x02:0x00,0x02:0x00,0x02:0x01
0x02:0x01,0x02:0x00,0x02:0x00,0x02:0x00,0x02:0x00,0x02:0x00,0x02:0x00,0x02:0x00,0x02:0x00,0x02:0x00,0x02:0x00,0x02:0x01
0x02:0x01,0x02:0x00,0x02:0x00,0x02:0x00,0x02:0x00,0x02:0x00,0x02:0x00,0x02:0x00,0x02:0x00,0x02:0x00,0x02:0x00,0x02:0x01
0x02:0x01,0x02:0x00,0x02:0x00,0x02:0x00,0x02:0x00,0x02:0x00,0x02:0x00,0x02:0x00,0x02:0x00,0x02:0x00,0x02:0x00,0x02:0x01
0x02:0x01,0x02:0x00,0x02:0x00,0x02:0x00,0x02:0x00,0x02:0x00,0x02:0x00,0x02:0x00,0x02:0x00,0x02:0x00,0x02:0x00,0x02:0x01
0x02:0x01,0x02:0x00,0x02:0x00,0x02:0x00,0x02:0x00,0x02:0x00,0x02:0x00,0x02:0x00,0x02:0x00,0x02:0x00,0xFF:0x00,0x02:0x01
0x02:0x01,0x02:0x01,0x02:0x01,0x02:0x01,0x02:0x01,0x02:0x01,0x02:0x01,0x02:0x01,0x02:0x01,0x02:0x01,0x02:0x01,0x02:0x01
